name,cluster,URL,TITLE,TEXT_LENGTH,degree,indegree,outdegree,betweenness
tools/spatial-analyst-toolbox/analysis-environments-and-spatial-analyst,1,http://desktop.arcgis.com/en/arcmap/10.3/tools/spatial-analyst-toolbox/analysis-environments-and-spatial-analyst.htm,Analysis environments and Spatial Analyst—Help | ArcGIS for Desktop,13141,166,165,1,2349.333333
tools/conversion-toolbox/polygon-to-raster,1,http://desktop.arcgis.com/en/arcmap/10.3/tools/conversion-toolbox/polygon-to-raster.htm,Polygon to Raster—Help | ArcGIS for Desktop,8736,14,14,0,0
tools/spatial-analyst-toolbox/con-,1,http://desktop.arcgis.com/en/arcmap/10.3/tools/spatial-analyst-toolbox/con-.htm,Con—Help | ArcGIS for Desktop,9753,7,6,1,4.909210526
tools/spatial-analyst-toolbox/euclidean-direction,1,http://desktop.arcgis.com/en/arcmap/10.3/tools/spatial-analyst-toolbox/euclidean-direction.htm,Euclidean Direction—Help | ArcGIS for Desktop,10940,9,4,5,4.047619048
tools/spatial-analyst-toolbox/euclidean-allocation,1,http://desktop.arcgis.com/en/arcmap/10.3/tools/spatial-analyst-toolbox/euclidean-allocation.htm,Euclidean Allocation—Help | ArcGIS for Desktop,12306,9,4,5,4.047619048
tools/spatial-analyst-toolbox/euclidean-distance,1,http://desktop.arcgis.com/en/arcmap/10.3/tools/spatial-analyst-toolbox/euclidean-distance.htm,Euclidean Distance—Help | ArcGIS for Desktop,10666,9,4,5,4.047619048
tools/spatial-analyst-toolbox/understanding-euclidean-distance-analysis,1,http://desktop.arcgis.com/en/arcmap/10.3/tools/spatial-analyst-toolbox/understanding-euclidean-distance-analysis.htm,Understanding Euclidean distance analysis—Help | ArcGIS for Desktop,9949,10,3,7,6
tools/spatial-analyst-toolbox/create-random-raster,1,http://desktop.arcgis.com/en/arcmap/10.3/tools/spatial-analyst-toolbox/create-random-raster.htm,Create Random Raster—Help | ArcGIS for Desktop,8030,4,2,2,0
tools/spatial-analyst-toolbox/visibility,1,http://desktop.arcgis.com/en/arcmap/10.3/tools/spatial-analyst-toolbox/visibility.htm,Visibility—Help | ArcGIS for Desktop,17366,3,2,1,0
tools/spatial-analyst-toolbox/viewshed-2,1,http://desktop.arcgis.com/en/arcmap/10.3/tools/spatial-analyst-toolbox/viewshed-2.htm,Viewshed 2—Help | ArcGIS for Desktop,20380,1,0,1,0
tools/spatial-analyst-toolbox/viewshed,1,http://desktop.arcgis.com/en/arcmap/10.3/tools/spatial-analyst-toolbox/viewshed.htm,Viewshed—Help | ArcGIS for Desktop,9316,4,1,3,0
tools/spatial-analyst-toolbox/slope,1,http://desktop.arcgis.com/en/arcmap/10.3/tools/spatial-analyst-toolbox/slope.htm,Slope—Help | ArcGIS for Desktop,7885,1,0,1,0
tools/spatial-analyst-toolbox/observer-points,1,http://desktop.arcgis.com/en/arcmap/10.3/tools/spatial-analyst-toolbox/observer-points.htm,Observer Points—Help | ArcGIS for Desktop,9193,4,1,3,0
tools/spatial-analyst-toolbox/hillshade,1,http://desktop.arcgis.com/en/arcmap/10.3/tools/spatial-analyst-toolbox/hillshade.htm,Hillshade—Help | ArcGIS for Desktop,9646,3,0,3,0
tools/spatial-analyst-toolbox/cut-fill,1,http://desktop.arcgis.com/en/arcmap/10.3/tools/spatial-analyst-toolbox/cut-fill.htm,Cut Fill—Help | ArcGIS for Desktop,9074,2,0,2,0
tools/spatial-analyst-toolbox/curvature,1,http://desktop.arcgis.com/en/arcmap/10.3/tools/spatial-analyst-toolbox/curvature.htm,Curvature—Help | ArcGIS for Desktop,8655,1,0,1,0
tools/spatial-analyst-toolbox/zonal-histogram,1,http://desktop.arcgis.com/en/arcmap/10.3/tools/spatial-analyst-toolbox/zonal-histogram.htm,Zonal Histogram—Help | ArcGIS for Desktop,11588,2,0,2,0
tools/spatial-analyst-toolbox/create-normal-raster,1,http://desktop.arcgis.com/en/arcmap/10.3/tools/spatial-analyst-toolbox/create-normal-raster.htm,Create Normal Raster—Help | ArcGIS for Desktop,7882,4,1,3,0
tools/spatial-analyst-toolbox/create-constant-raster,1,http://desktop.arcgis.com/en/arcmap/10.3/tools/spatial-analyst-toolbox/create-constant-raster.htm,Create Constant Raster—Help | ArcGIS for Desktop,7848,3,1,2,5.857142857
tools/spatial-analyst-toolbox/train-maximum-likelihood-classifier,1,http://desktop.arcgis.com/en/arcmap/10.3/tools/spatial-analyst-toolbox/train-maximum-likelihood-classifier.htm,Train Maximum Likelihood Classifier—Help | ArcGIS for Desktop,8394,3,0,3,0
tools/spatial-analyst-toolbox/segment-mean-shift,1,http://desktop.arcgis.com/en/arcmap/10.3/tools/spatial-analyst-toolbox/segment-mean-shift.htm,Segment Mean Shift—Help | ArcGIS for Desktop,8011,3,2,1,4.333333333
tools/spatial-analyst-toolbox/compute-segment-attributes,1,http://desktop.arcgis.com/en/arcmap/10.3/tools/spatial-analyst-toolbox/compute-segment-attributes.htm,Compute Segment Attributes—Help | ArcGIS for Desktop,8361,2,0,2,0
tools/spatial-analyst-toolbox/classify-raster,1,http://desktop.arcgis.com/en/arcmap/10.3/tools/spatial-analyst-toolbox/classify-raster.htm,Classify Raster—Help | ArcGIS for Desktop,6928,2,1,1,4.333333333
tools/spatial-analyst-toolbox/point-statistics,1,http://desktop.arcgis.com/en/arcmap/10.3/tools/spatial-analyst-toolbox/point-statistics.htm,Point Statistics—Help | ArcGIS for Desktop,9314,1,0,1,0
tools/spatial-analyst-toolbox/edit-signatures,1,http://desktop.arcgis.com/en/arcmap/10.3/tools/spatial-analyst-toolbox/edit-signatures.htm,Edit Signatures—Help | ArcGIS for Desktop,9009,1,0,1,0
tools/spatial-analyst-toolbox/create-signatures,1,http://desktop.arcgis.com/en/arcmap/10.3/tools/spatial-analyst-toolbox/create-signatures.htm,Create Signatures—Help | ArcGIS for Desktop,8981,1,0,1,0
tools/spatial-analyst-toolbox/line-statistics,1,http://desktop.arcgis.com/en/arcmap/10.3/tools/spatial-analyst-toolbox/line-statistics.htm,Line Statistics—Help | ArcGIS for Desktop,9307,1,0,1,0
tools/spatial-analyst-toolbox/focal-flow,1,http://desktop.arcgis.com/en/arcmap/10.3/tools/spatial-analyst-toolbox/focal-flow.htm,Focal Flow—Help | ArcGIS for Desktop,6699,1,0,1,0
tools/spatial-analyst-toolbox/tanh,1,http://desktop.arcgis.com/en/arcmap/10.3/tools/spatial-analyst-toolbox/tanh.htm,TanH—Help | ArcGIS for Desktop,6351,1,0,1,0
tools/spatial-analyst-toolbox/bitwise-xor,1,http://desktop.arcgis.com/en/arcmap/10.3/tools/spatial-analyst-toolbox/bitwise-xor.htm,Bitwise XOr—Help | ArcGIS for Desktop,7246,1,0,1,0
tools/spatial-analyst-toolbox/bitwise-right-shift,1,http://desktop.arcgis.com/en/arcmap/10.3/tools/spatial-analyst-toolbox/bitwise-right-shift.htm,Bitwise Right Shift—Help | ArcGIS for Desktop,7407,1,0,1,0
tools/spatial-analyst-toolbox/bitwise-or,1,http://desktop.arcgis.com/en/arcmap/10.3/tools/spatial-analyst-toolbox/bitwise-or.htm,Bitwise Or—Help | ArcGIS for Desktop,7200,1,0,1,0
tools/spatial-analyst-toolbox/bitwise-not,1,http://desktop.arcgis.com/en/arcmap/10.3/tools/spatial-analyst-toolbox/bitwise-not.htm,Bitwise Not—Help | ArcGIS for Desktop,6707,1,0,1,0
tools/spatial-analyst-toolbox/bitwise-left-shift,1,http://desktop.arcgis.com/en/arcmap/10.3/tools/spatial-analyst-toolbox/bitwise-left-shift.htm,Bitwise Left Shift—Help | ArcGIS for Desktop,7334,1,0,1,0
tools/spatial-analyst-toolbox/bitwise-and,1,http://desktop.arcgis.com/en/arcmap/10.3/tools/spatial-analyst-toolbox/bitwise-and.htm,Bitwise And—Help | ArcGIS for Desktop,7176,1,0,1,0
tools/spatial-analyst-toolbox/over,1,http://desktop.arcgis.com/en/arcmap/10.3/tools/spatial-analyst-toolbox/over.htm,Over—Help | ArcGIS for Desktop,6682,1,0,1,0
tools/spatial-analyst-toolbox/is-null,1,http://desktop.arcgis.com/en/arcmap/10.3/tools/spatial-analyst-toolbox/is-null.htm,Is Null—Help | ArcGIS for Desktop,6061,1,0,1,0
tools/spatial-analyst-toolbox/inlist,1,http://desktop.arcgis.com/en/arcmap/10.3/tools/spatial-analyst-toolbox/inlist.htm,InList—Help | ArcGIS for Desktop,6985,1,0,1,0
tools/spatial-analyst-toolbox/diff,1,http://desktop.arcgis.com/en/arcmap/10.3/tools/spatial-analyst-toolbox/diff.htm,Diff—Help | ArcGIS for Desktop,6935,1,0,1,0
tools/spatial-analyst-toolbox/not-equal,1,http://desktop.arcgis.com/en/arcmap/10.3/tools/spatial-analyst-toolbox/not-equal.htm,Not Equal—Help | ArcGIS for Desktop,6823,1,0,1,0
tools/spatial-analyst-toolbox/less-than-equal,1,http://desktop.arcgis.com/en/arcmap/10.3/tools/spatial-analyst-toolbox/less-than-equal.htm,Less Than Equal—Help | ArcGIS for Desktop,6937,1,0,1,0
tools/spatial-analyst-toolbox/greater-than-equal,1,http://desktop.arcgis.com/en/arcmap/10.3/tools/spatial-analyst-toolbox/greater-than-equal.htm,Greater Than Equal—Help | ArcGIS for Desktop,7024,1,0,1,0
tools/spatial-analyst-toolbox/equal-to,1,http://desktop.arcgis.com/en/arcmap/10.3/tools/spatial-analyst-toolbox/equal-to.htm,Equal To—Help | ArcGIS for Desktop,6867,1,0,1,0
tools/spatial-analyst-toolbox/combinatorial-xor,1,http://desktop.arcgis.com/en/arcmap/10.3/tools/spatial-analyst-toolbox/combinatorial-xor.htm,Combinatorial XOr—Help | ArcGIS for Desktop,7110,1,0,1,0
tools/spatial-analyst-toolbox/combinatorial-and,1,http://desktop.arcgis.com/en/arcmap/10.3/tools/spatial-analyst-toolbox/combinatorial-and.htm,Combinatorial And—Help | ArcGIS for Desktop,7061,1,0,1,0
tools/spatial-analyst-toolbox/boolean-xor,1,http://desktop.arcgis.com/en/arcmap/10.3/tools/spatial-analyst-toolbox/boolean-xor.htm,Boolean XOr—Help | ArcGIS for Desktop,7339,1,0,1,0
tools/spatial-analyst-toolbox/boolean-or,1,http://desktop.arcgis.com/en/arcmap/10.3/tools/spatial-analyst-toolbox/boolean-or.htm,Boolean Or—Help | ArcGIS for Desktop,7248,1,0,1,0
tools/spatial-analyst-toolbox/boolean-not,1,http://desktop.arcgis.com/en/arcmap/10.3/tools/spatial-analyst-toolbox/boolean-not.htm,Boolean Not—Help | ArcGIS for Desktop,6814,1,0,1,0
tools/spatial-analyst-toolbox/boolean-and,1,http://desktop.arcgis.com/en/arcmap/10.3/tools/spatial-analyst-toolbox/boolean-and.htm,Boolean And—Help | ArcGIS for Desktop,7307,1,0,1,0
tools/spatial-analyst-toolbox/tan,1,http://desktop.arcgis.com/en/arcmap/10.3/tools/spatial-analyst-toolbox/tan.htm,Tan—Help | ArcGIS for Desktop,6795,1,0,1,0
tools/spatial-analyst-toolbox/sinh,1,http://desktop.arcgis.com/en/arcmap/10.3/tools/spatial-analyst-toolbox/sinh.htm,SinH—Help | ArcGIS for Desktop,6340,1,0,1,0
tools/spatial-analyst-toolbox/sin,1,http://desktop.arcgis.com/en/arcmap/10.3/tools/spatial-analyst-toolbox/sin.htm,Sin—Help | ArcGIS for Desktop,6766,1,0,1,0
tools/spatial-analyst-toolbox/cosh,1,http://desktop.arcgis.com/en/arcmap/10.3/tools/spatial-analyst-toolbox/cosh.htm,CosH—Help | ArcGIS for Desktop,6351,1,0,1,0
tools/spatial-analyst-toolbox/cos,1,http://desktop.arcgis.com/en/arcmap/10.3/tools/spatial-analyst-toolbox/cos.htm,Cos—Help | ArcGIS for Desktop,6778,1,0,1,0
tools/spatial-analyst-toolbox/atanh,1,http://desktop.arcgis.com/en/arcmap/10.3/tools/spatial-analyst-toolbox/atanh.htm,ATanH—Help | ArcGIS for Desktop,6491,1,0,1,0
tools/spatial-analyst-toolbox/atan2,1,http://desktop.arcgis.com/en/arcmap/10.3/tools/spatial-analyst-toolbox/atan2.htm,ATan2—Help | ArcGIS for Desktop,8019,1,0,1,0
tools/spatial-analyst-toolbox/atan,1,http://desktop.arcgis.com/en/arcmap/10.3/tools/spatial-analyst-toolbox/atan.htm,ATan—Help | ArcGIS for Desktop,6710,1,0,1,0
tools/spatial-analyst-toolbox/asinh,1,http://desktop.arcgis.com/en/arcmap/10.3/tools/spatial-analyst-toolbox/asinh.htm,ASinH—Help | ArcGIS for Desktop,6419,1,0,1,0
tools/spatial-analyst-toolbox/asin,1,http://desktop.arcgis.com/en/arcmap/10.3/tools/spatial-analyst-toolbox/asin.htm,ASin—Help | ArcGIS for Desktop,6649,1,0,1,0
tools/spatial-analyst-toolbox/acosh,1,http://desktop.arcgis.com/en/arcmap/10.3/tools/spatial-analyst-toolbox/acosh.htm,ACosH—Help | ArcGIS for Desktop,6524,1,0,1,0
tools/spatial-analyst-toolbox/acos,1,http://desktop.arcgis.com/en/arcmap/10.3/tools/spatial-analyst-toolbox/acos.htm,ACos—Help | ArcGIS for Desktop,6656,1,0,1,0
tools/spatial-analyst-toolbox/times,1,http://desktop.arcgis.com/en/arcmap/10.3/tools/spatial-analyst-toolbox/times.htm,Times—Help | ArcGIS for Desktop,6708,2,1,1,0
tools/spatial-analyst-toolbox/round-up,1,http://desktop.arcgis.com/en/arcmap/10.3/tools/spatial-analyst-toolbox/round-up.htm,Round Up—Help | ArcGIS for Desktop,6395,3,1,2,0
tools/spatial-analyst-toolbox/round-down,1,http://desktop.arcgis.com/en/arcmap/10.3/tools/spatial-analyst-toolbox/round-down.htm,Round Down—Help | ArcGIS for Desktop,6773,3,1,2,0
tools/spatial-analyst-toolbox/negate,1,http://desktop.arcgis.com/en/arcmap/10.3/tools/spatial-analyst-toolbox/negate.htm,Negate—Help | ArcGIS for Desktop,6118,1,0,1,0
tools/spatial-analyst-toolbox/mod,1,http://desktop.arcgis.com/en/arcmap/10.3/tools/spatial-analyst-toolbox/mod.htm,Mod—Help | ArcGIS for Desktop,7160,1,0,1,0
tools/spatial-analyst-toolbox/int,1,http://desktop.arcgis.com/en/arcmap/10.3/tools/spatial-analyst-toolbox/int.htm,Int—Help | ArcGIS for Desktop,6853,3,1,2,0
tools/spatial-analyst-toolbox/float,1,http://desktop.arcgis.com/en/arcmap/10.3/tools/spatial-analyst-toolbox/float.htm,Float—Help | ArcGIS for Desktop,5980,3,1,2,0
tools/spatial-analyst-toolbox/abs,1,http://desktop.arcgis.com/en/arcmap/10.3/tools/spatial-analyst-toolbox/abs.htm,Abs—Help | ArcGIS for Desktop,5976,1,0,1,0
tools/spatial-analyst-toolbox/thin,1,http://desktop.arcgis.com/en/arcmap/10.3/tools/spatial-analyst-toolbox/thin.htm,Thin—Help | ArcGIS for Desktop,8378,1,0,1,0
tools/spatial-analyst-toolbox/region-group,1,http://desktop.arcgis.com/en/arcmap/10.3/tools/spatial-analyst-toolbox/region-group.htm,Region Group—Help | ArcGIS for Desktop,10788,3,1,2,5.857142857
tools/spatial-analyst-toolbox/pick,1,http://desktop.arcgis.com/en/arcmap/10.3/tools/spatial-analyst-toolbox/pick.htm,Pick—Help | ArcGIS for Desktop,7225,1,0,1,0
tools/spatial-analyst-toolbox/contour-with-barriers,2,http://desktop.arcgis.com/en/arcmap/10.3/tools/spatial-analyst-toolbox/contour-with-barriers.htm,Contour with Barriers—Help | ArcGIS for Desktop,11872,3,0,3,0
tools/spatial-analyst-toolbox/contour-list,2,http://desktop.arcgis.com/en/arcmap/10.3/tools/spatial-analyst-toolbox/contour-list.htm,Contour List—Help | ArcGIS for Desktop,7181,3,0,3,0
tools/spatial-analyst-toolbox/contour,2,http://desktop.arcgis.com/en/arcmap/10.3/tools/spatial-analyst-toolbox/contour.htm,Contour—Help | ArcGIS for Desktop,8713,3,0,3,0
tools/spatial-analyst-toolbox/focal-statistics,2,http://desktop.arcgis.com/en/arcmap/10.3/tools/spatial-analyst-toolbox/focal-statistics.htm,Focal Statistics—Help | ArcGIS for Desktop,9641,7,5,2,9.5
tools/spatial-analyst-toolbox/filter,2,http://desktop.arcgis.com/en/arcmap/10.3/tools/spatial-analyst-toolbox/filter.htm,Filter—Help | ArcGIS for Desktop,6974,6,3,3,3
tools/spatial-analyst-toolbox/block-statistics,2,http://desktop.arcgis.com/en/arcmap/10.3/tools/spatial-analyst-toolbox/block-statistics.htm,Block Statistics—Help | ArcGIS for Desktop,10468,4,2,2,14.83333333
tools/spatial-analyst-toolbox/calculating-statistics-for-overlapping-and-non-overlapping-neighborhoods,2,http://desktop.arcgis.com/en/arcmap/10.3/tools/spatial-analyst-toolbox/calculating-statistics-for-overlapping-and-non-overlapping-neighborhoods.htm,Calculating statistics for overlapping and non-overlapping neighborhoods—Help | ArcGIS for Desktop,6732,5,3,2,8
tools/spatial-analyst-toolbox/aggregate,2,http://desktop.arcgis.com/en/arcmap/10.3/tools/spatial-analyst-toolbox/aggregate.htm,Aggregate—Help | ArcGIS for Desktop,9511,4,2,2,8.666666667
tools/spatial-analyst-toolbox/altering-the-resolution,2,http://desktop.arcgis.com/en/arcmap/10.3/tools/spatial-analyst-toolbox/altering-the-resolution.htm,Altering the resolution of a raster—Help | ArcGIS for Desktop,5848,4,1,3,3
tools/network-analyst-toolbox/make-od-cost-matrix-layer,3,http://desktop.arcgis.com/en/arcmap/10.3/tools/network-analyst-toolbox/make-od-cost-matrix-layer.htm,Make OD Cost Matrix Layer—Help | ArcGIS for Desktop,20386,3,0,3,0
tools/network-analyst-toolbox/solve,3,http://desktop.arcgis.com/en/arcmap/10.3/tools/network-analyst-toolbox/solve.htm,Solve—Help | ArcGIS for Desktop,10004,6,6,0,0
tools/network-analyst-toolbox/add-locations,3,http://desktop.arcgis.com/en/arcmap/10.3/tools/network-analyst-toolbox/add-locations.htm,Add Locations—Help | ArcGIS for Desktop,19013,8,8,0,0
tools/network-analyst-toolbox/make-route-layer,3,http://desktop.arcgis.com/en/arcmap/10.3/tools/network-analyst-toolbox/make-route-layer.htm,Make Route Layer—Help | ArcGIS for Desktop,19798,3,0,3,0
tools/network-analyst-toolbox/make-service-area-layer,3,http://desktop.arcgis.com/en/arcmap/10.3/tools/network-analyst-toolbox/make-service-area-layer.htm,Make Service Area Layer—Help | ArcGIS for Desktop,26689,9,3,6,12
tools/network-analyst-toolbox/make-closest-facility-layer,3,http://desktop.arcgis.com/en/arcmap/10.3/tools/network-analyst-toolbox/make-closest-facility-layer.htm,Make Closest Facility Layer—Help | ArcGIS for Desktop,17902,7,2,5,12
tools/network-analyst-toolbox/find-closest-facilities,3,http://desktop.arcgis.com/en/arcmap/10.3/tools/network-analyst-toolbox/find-closest-facilities.htm,Find Closest Facilities—Help | ArcGIS for Desktop,47958,4,2,2,0
tools/network-analyst-toolbox/make-vehicle-routing-problem-layer,3,http://desktop.arcgis.com/en/arcmap/10.3/tools/network-analyst-toolbox/make-vehicle-routing-problem-layer.htm,Make Vehicle Routing Problem Layer—Help | ArcGIS for Desktop,22811,5,1,4,0
tools/network-analyst-toolbox/make-location-allocation-layer,3,http://desktop.arcgis.com/en/arcmap/10.3/tools/network-analyst-toolbox/make-location-allocation-layer.htm,Make Location-Allocation Layer—Help | ArcGIS for Desktop,23237,3,0,3,0
tools/network-analyst-toolbox/calculate-locations,3,http://desktop.arcgis.com/en/arcmap/10.3/tools/network-analyst-toolbox/calculate-locations.htm,Calculate Locations—Help | ArcGIS for Desktop,17138,1,0,1,0
tools/network-analyst-toolbox/add-field-to-analysis-layer,3,http://desktop.arcgis.com/en/arcmap/10.3/tools/network-analyst-toolbox/add-field-to-analysis-layer.htm,Add Field to Analysis Layer—Help | ArcGIS for Desktop,11719,1,0,1,0
tools/network-analyst-toolbox/generate-service-areas,3,http://desktop.arcgis.com/en/arcmap/10.3/tools/network-analyst-toolbox/generate-service-areas.htm,Generate Service Areas—Help | ArcGIS for Desktop,39703,6,3,3,0
tools/data-management-toolbox/remove-rule-from-topology,4,http://desktop.arcgis.com/en/arcmap/10.3/tools/data-management-toolbox/remove-rule-from-topology.htm,Remove Rule From Topology—Help | ArcGIS for Desktop,6156,1,0,1,0
tools/data-management-toolbox/remove-feature-class-from-topology,4,http://desktop.arcgis.com/en/arcmap/10.3/tools/data-management-toolbox/remove-feature-class-from-topology.htm,Remove Feature Class From Topology—Help | ArcGIS for Desktop,5639,1,0,1,0
tools/data-management-toolbox/upgrade-geodatabase,4,http://desktop.arcgis.com/en/arcmap/10.3/tools/data-management-toolbox/upgrade-geodatabase.htm,Upgrade Geodatabase—Help | ArcGIS for Desktop,15123,4,4,0,0
tools/data-management-toolbox/create-topology,4,http://desktop.arcgis.com/en/arcmap/10.3/tools/data-management-toolbox/create-topology.htm,Create Topology—Help | ArcGIS for Desktop,5660,2,0,2,0
tools/data-management-toolbox/add-rule-to-topology,4,http://desktop.arcgis.com/en/arcmap/10.3/tools/data-management-toolbox/add-rule-to-topology.htm,Add Rule To Topology—Help | ArcGIS for Desktop,6377,2,1,1,0.5
tools/data-management-toolbox/add-feature-class-to-topology,4,http://desktop.arcgis.com/en/arcmap/10.3/tools/data-management-toolbox/add-feature-class-to-topology.htm,Add Feature Class To Topology—Help | ArcGIS for Desktop,7023,2,1,1,0.5
tools/data-management-toolbox/select-layer-by-location,5,http://desktop.arcgis.com/en/arcmap/10.3/tools/data-management-toolbox/select-layer-by-location.htm,Select Layer By Location—Help | ArcGIS for Desktop,13932,10,3,7,78.60714286
tools/data-management-toolbox/export-topology-errors,5,http://desktop.arcgis.com/en/arcmap/10.3/tools/data-management-toolbox/export-topology-errors.htm,Export Topology Errors—Help | ArcGIS for Desktop,7023,2,0,2,0
tools/data-management-toolbox/creating-and-using-layer-selections,5,http://desktop.arcgis.com/en/arcmap/10.3/tools/data-management-toolbox/creating-and-using-layer-selections.htm,Creating and using layer selections—Help | ArcGIS for Desktop,5389,5,1,4,9.916666667
tools/data-management-toolbox/working-with-layers-and-table-views,5,http://desktop.arcgis.com/en/arcmap/10.3/tools/data-management-toolbox/working-with-layers-and-table-views.htm,Working with layers and table views—Help | ArcGIS for Desktop,6166,6,4,2,225.4285714
tools/data-management-toolbox/select-by-location-3d-relationships,5,http://desktop.arcgis.com/en/arcmap/10.3/tools/data-management-toolbox/select-by-location-3d-relationships.htm,Select By Location 3D relationships—Help | ArcGIS for Desktop,6235,3,3,0,0
tools/data-management-toolbox/get-count,5,http://desktop.arcgis.com/en/arcmap/10.3/tools/data-management-toolbox/get-count.htm,Get Count—Help | ArcGIS for Desktop,5442,4,3,1,11.25
tools/data-management-toolbox/select-by-location-within-a-layer,5,http://desktop.arcgis.com/en/arcmap/10.3/tools/data-management-toolbox/select-by-location-within-a-layer.htm,Select By Location: Select based on spatial relationship within the layer—Help | ArcGIS for Desktop,5837,4,2,2,6
tools/data-management-toolbox/select-by-location-graphical-examples,5,http://desktop.arcgis.com/en/arcmap/10.3/tools/data-management-toolbox/select-by-location-graphical-examples.htm,Select By Location: graphic examples—Help | ArcGIS for Desktop,13599,8,4,4,73.85714286
tools/data-management-toolbox/save-to-layer-file,5,http://desktop.arcgis.com/en/arcmap/10.3/tools/data-management-toolbox/save-to-layer-file.htm,Save To Layer File—Help | ArcGIS for Desktop,6507,12,9,3,108.75
tools/data-management-toolbox/copy-features,5,http://desktop.arcgis.com/en/arcmap/10.3/tools/data-management-toolbox/copy-features.htm,Copy Features—Help | ArcGIS for Desktop,7439,6,6,0,0
tools/data-management-toolbox/make-xy-event-layer,5,http://desktop.arcgis.com/en/arcmap/10.3/tools/data-management-toolbox/make-xy-event-layer.htm,Make XY Event Layer—Help | ArcGIS for Desktop,7559,5,3,2,41.39285714
tools/data-management-toolbox/project,5,http://desktop.arcgis.com/en/arcmap/10.3/tools/data-management-toolbox/project.htm,Project—Help | ArcGIS for Desktop,13947,3,1,2,58.25
tools/analysis-toolbox/spatial-join,5,http://desktop.arcgis.com/en/arcmap/10.3/tools/analysis-toolbox/spatial-join.htm,Spatial Join—Help | ArcGIS for Desktop,19530,8,3,5,60
tools/analysis-toolbox/summary-statistics,5,http://desktop.arcgis.com/en/arcmap/10.3/tools/analysis-toolbox/summary-statistics.htm,Summary Statistics—Help | ArcGIS for Desktop,10409,1,1,0,0
tools/analysis-toolbox/select,5,http://desktop.arcgis.com/en/arcmap/10.3/tools/analysis-toolbox/select.htm,Select—Help | ArcGIS for Desktop,6525,2,1,1,2.25
tools/spatial-analyst-toolbox/path-distance-back-link,6,http://desktop.arcgis.com/en/arcmap/10.3/tools/spatial-analyst-toolbox/path-distance-back-link.htm,Path Distance Back Link—Help | ArcGIS for Desktop,21486,13,5,8,18
tools/spatial-analyst-toolbox/aspect,6,http://desktop.arcgis.com/en/arcmap/10.3/tools/spatial-analyst-toolbox/aspect.htm,Aspect—Help | ArcGIS for Desktop,6559,4,3,1,0
tools/spatial-analyst-toolbox/how-the-horizonal-and-vertical-factors-affect-path-distance,6,http://desktop.arcgis.com/en/arcmap/10.3/tools/spatial-analyst-toolbox/how-the-horizonal-and-vertical-factors-affect-path-distance.htm,How the horizontal and vertical factors affect path distance—Help | ArcGIS for Desktop,21563,10,6,4,0
tools/spatial-analyst-toolbox/understanding-path-distance-analysis,6,http://desktop.arcgis.com/en/arcmap/10.3/tools/spatial-analyst-toolbox/understanding-path-distance-analysis.htm,Understanding path distance analysis—Help | ArcGIS for Desktop,18573,15,8,7,88
tools/spatial-analyst-toolbox/how-the-path-distance-tools-work,6,http://desktop.arcgis.com/en/arcmap/10.3/tools/spatial-analyst-toolbox/how-the-path-distance-tools-work.htm,How the path distance tools work—Help | ArcGIS for Desktop,10528,17,7,10,26.5
tools/spatial-analyst-toolbox/path-distance,6,http://desktop.arcgis.com/en/arcmap/10.3/tools/spatial-analyst-toolbox/path-distance.htm,Path Distance—Help | ArcGIS for Desktop,21464,13,5,8,18
tools/spatial-analyst-toolbox/cost-back-link,6,http://desktop.arcgis.com/en/arcmap/10.3/tools/spatial-analyst-toolbox/cost-back-link.htm,Cost Back Link—Help | ArcGIS for Desktop,11184,11,5,6,9.916666667
tools/spatial-analyst-toolbox/cost-path,6,http://desktop.arcgis.com/en/arcmap/10.3/tools/spatial-analyst-toolbox/cost-path.htm,Cost Path—Help | ArcGIS for Desktop,11795,11,3,8,40.93333333
tools/spatial-analyst-toolbox/understanding-cost-distance-analysis,6,http://desktop.arcgis.com/en/arcmap/10.3/tools/spatial-analyst-toolbox/understanding-cost-distance-analysis.htm,Understanding cost distance analysis—Help | ArcGIS for Desktop,10369,13,7,6,83.16666667
tools/spatial-analyst-toolbox/creating-the-least-cost-path,6,http://desktop.arcgis.com/en/arcmap/10.3/tools/spatial-analyst-toolbox/creating-the-least-cost-path.htm,Creating the least-cost path—Help | ArcGIS for Desktop,7391,6,2,4,64.25
tools/spatial-analyst-toolbox/how-the-cost-distance-tools-work,6,http://desktop.arcgis.com/en/arcmap/10.3/tools/spatial-analyst-toolbox/how-the-cost-distance-tools-work.htm,How cost distance tools work—Help | ArcGIS for Desktop,10898,10,6,4,17
tools/spatial-analyst-toolbox/cost-distance,6,http://desktop.arcgis.com/en/arcmap/10.3/tools/spatial-analyst-toolbox/cost-distance.htm,Cost Distance—Help | ArcGIS for Desktop,11830,13,5,8,35.91666667
tools/spatial-analyst-toolbox/corridor,6,http://desktop.arcgis.com/en/arcmap/10.3/tools/spatial-analyst-toolbox/corridor.htm,Corridor—Help | ArcGIS for Desktop,6327,4,2,2,5.2
tools/spatial-analyst-toolbox/path-distance-allocation,6,http://desktop.arcgis.com/en/arcmap/10.3/tools/spatial-analyst-toolbox/path-distance-allocation.htm,Path Distance Allocation—Help | ArcGIS for Desktop,23356,13,5,8,18
tools/spatial-analyst-toolbox/set-null,6,http://desktop.arcgis.com/en/arcmap/10.3/tools/spatial-analyst-toolbox/set-null.htm,Set Null—Help | ArcGIS for Desktop,7945,2,1,1,0
tools/spatial-analyst-toolbox/creating-a-least-cost-corridor,6,http://desktop.arcgis.com/en/arcmap/10.3/tools/spatial-analyst-toolbox/creating-a-least-cost-corridor.htm,Creating a least cost corridor—Help | ArcGIS for Desktop,7062,8,1,7,19
tools/spatial-analyst-toolbox/cost-allocation,6,http://desktop.arcgis.com/en/arcmap/10.3/tools/spatial-analyst-toolbox/cost-allocation.htm,Cost Allocation—Help | ArcGIS for Desktop,13826,11,5,6,9.916666667
tools/spatial-analyst-toolbox/test,6,http://desktop.arcgis.com/en/arcmap/10.3/tools/spatial-analyst-toolbox/test.htm,Test—Help | ArcGIS for Desktop,6626,2,1,1,2.6
tools/spatial-analyst-toolbox/maximum-likelihood-classification,7,http://desktop.arcgis.com/en/arcmap/10.3/tools/spatial-analyst-toolbox/maximum-likelihood-classification.htm,Maximum Likelihood Classification—Help | ArcGIS for Desktop,11114,5,4,1,14.54761905
tools/spatial-analyst-toolbox/iso-cluster-unsupervised-classification,7,http://desktop.arcgis.com/en/arcmap/10.3/tools/spatial-analyst-toolbox/iso-cluster-unsupervised-classification.htm,Iso Cluster Unsupervised Classification—Help | ArcGIS for Desktop,9872,2,1,1,6.19047619
tools/spatial-analyst-toolbox/iso-cluster,7,http://desktop.arcgis.com/en/arcmap/10.3/tools/spatial-analyst-toolbox/iso-cluster.htm,Iso Cluster—Help | ArcGIS for Desktop,9303,4,2,2,13.38095238
tools/spatial-analyst-toolbox/class-probability,7,http://desktop.arcgis.com/en/arcmap/10.3/tools/spatial-analyst-toolbox/class-probability.htm,Class Probability—Help | ArcGIS for Desktop,10551,3,2,1,10.21428571
tools/spatial-analyst-toolbox/performing-the-classification,7,http://desktop.arcgis.com/en/arcmap/10.3/tools/spatial-analyst-toolbox/performing-the-classification.htm,Performing the classification—Help | ArcGIS for Desktop,9423,5,1,4,9.428571429
tools/spatial-analyst-toolbox/producing-signature-files-class-and-cluster-analysis,7,http://desktop.arcgis.com/en/arcmap/10.3/tools/spatial-analyst-toolbox/producing-signature-files-class-and-cluster-analysis.htm,"Producing signature files, class, and cluster analysis—Help | ArcGIS for Desktop",11549,4,1,3,7.571428571
tools/spatial-analyst-toolbox/understanding-multivariate-classification,7,http://desktop.arcgis.com/en/arcmap/10.3/tools/spatial-analyst-toolbox/understanding-multivariate-classification.htm,Understanding multivariate classification—Help | ArcGIS for Desktop,8208,3,0,3,0
tools/spatial-analyst-toolbox/solar-radiation-graphics,8,http://desktop.arcgis.com/en/arcmap/10.3/tools/spatial-analyst-toolbox/solar-radiation-graphics.htm,Solar Radiation Graphics—Help | ArcGIS for Desktop,15471,2,1,1,13
tools/spatial-analyst-toolbox/points-solar-radiation,8,http://desktop.arcgis.com/en/arcmap/10.3/tools/spatial-analyst-toolbox/points-solar-radiation.htm,Points Solar Radiation—Help | ArcGIS for Desktop,21361,5,2,3,13
tools/spatial-analyst-toolbox/area-solar-radiation,8,http://desktop.arcgis.com/en/arcmap/10.3/tools/spatial-analyst-toolbox/area-solar-radiation.htm,Area Solar Radiation—Help | ArcGIS for Desktop,20850,5,2,3,13
tools/spatial-analyst-toolbox/how-solar-radiation-is-calculated,8,http://desktop.arcgis.com/en/arcmap/10.3/tools/spatial-analyst-toolbox/how-solar-radiation-is-calculated.htm,How solar radiation is calculated—Help | ArcGIS for Desktop,9458,8,5,3,34
tools/spatial-analyst-toolbox/modeling-solar-radiation,8,http://desktop.arcgis.com/en/arcmap/10.3/tools/spatial-analyst-toolbox/modeling-solar-radiation.htm,Modeling solar radiation—Help | ArcGIS for Desktop,11237,4,1,3,0
tools/spatial-analyst-toolbox/understanding-solar-radiation-analysis,8,http://desktop.arcgis.com/en/arcmap/10.3/tools/spatial-analyst-toolbox/understanding-solar-radiation-analysis.htm,Understanding solar radiation analysis—Help | ArcGIS for Desktop,5216,3,1,2,0
tools/spatial-analyst-toolbox/flow-direction,9,http://desktop.arcgis.com/en/arcmap/10.3/tools/spatial-analyst-toolbox/flow-direction.htm,Flow Direction—Help | ArcGIS for Desktop,9074,14,13,1,7.326754386
tools/spatial-analyst-toolbox/zonal-fill,9,http://desktop.arcgis.com/en/arcmap/10.3/tools/spatial-analyst-toolbox/zonal-fill.htm,Zonal Fill—Help | ArcGIS for Desktop,6440,2,1,1,5.01754386
tools/spatial-analyst-toolbox/minus,9,http://desktop.arcgis.com/en/arcmap/10.3/tools/spatial-analyst-toolbox/minus.htm,Minus—Help | ArcGIS for Desktop,6700,3,2,1,5.01754386
tools/spatial-analyst-toolbox/watershed,9,http://desktop.arcgis.com/en/arcmap/10.3/tools/spatial-analyst-toolbox/watershed.htm,Watershed—Help | ArcGIS for Desktop,7371,8,4,4,31.19517544
tools/spatial-analyst-toolbox/stream-to-feature,9,http://desktop.arcgis.com/en/arcmap/10.3/tools/spatial-analyst-toolbox/stream-to-feature.htm,Stream to Feature—Help | ArcGIS for Desktop,7327,2,0,2,0
tools/spatial-analyst-toolbox/stream-order,9,http://desktop.arcgis.com/en/arcmap/10.3/tools/spatial-analyst-toolbox/stream-order.htm,Stream Order—Help | ArcGIS for Desktop,7953,3,1,2,2.309210526
tools/spatial-analyst-toolbox/stream-link,9,http://desktop.arcgis.com/en/arcmap/10.3/tools/spatial-analyst-toolbox/stream-link.htm,Stream Link—Help | ArcGIS for Desktop,6314,2,0,2,0
tools/spatial-analyst-toolbox/snap-pour-point,9,http://desktop.arcgis.com/en/arcmap/10.3/tools/spatial-analyst-toolbox/snap-pour-point.htm,Snap Pour Point—Help | ArcGIS for Desktop,7875,2,1,1,0
tools/spatial-analyst-toolbox/sink,9,http://desktop.arcgis.com/en/arcmap/10.3/tools/spatial-analyst-toolbox/sink.htm,Sink—Help | ArcGIS for Desktop,6249,6,4,2,13.34429825
tools/spatial-analyst-toolbox/flow-length,9,http://desktop.arcgis.com/en/arcmap/10.3/tools/spatial-analyst-toolbox/flow-length.htm,Flow Length—Help | ArcGIS for Desktop,6994,3,1,2,2.309210526
tools/spatial-analyst-toolbox/flow-accumulation,9,http://desktop.arcgis.com/en/arcmap/10.3/tools/spatial-analyst-toolbox/flow-accumulation.htm,Flow Accumulation—Help | ArcGIS for Desktop,7807,4,1,3,2.309210526
tools/spatial-analyst-toolbox/fill,9,http://desktop.arcgis.com/en/arcmap/10.3/tools/spatial-analyst-toolbox/fill.htm,Fill—Help | ArcGIS for Desktop,8401,6,3,3,13.34429825
tools/spatial-analyst-toolbox/basin,9,http://desktop.arcgis.com/en/arcmap/10.3/tools/spatial-analyst-toolbox/basin.htm,Basin—Help | ArcGIS for Desktop,6469,3,0,3,0
tools/spatial-analyst-toolbox/hydrologic-analysis-sample-applications,9,http://desktop.arcgis.com/en/arcmap/10.3/tools/spatial-analyst-toolbox/hydrologic-analysis-sample-applications.htm,Hydrologic analysis sample applications—Help | ArcGIS for Desktop,6383,10,1,9,15.14035088
tools/spatial-analyst-toolbox/how-watershed-works,9,http://desktop.arcgis.com/en/arcmap/10.3/tools/spatial-analyst-toolbox/how-watershed-works.htm,How Watershed works—Help | ArcGIS for Desktop,5104,4,2,2,2.368421053
tools/spatial-analyst-toolbox/creating-a-depressionless-dem,9,http://desktop.arcgis.com/en/arcmap/10.3/tools/spatial-analyst-toolbox/creating-a-depressionless-dem.htm,Creating a depressionless DEM—Help | ArcGIS for Desktop,6971,13,4,9,108.4912281
tools/spatial-analyst-toolbox/deriving-runoff-characteristics,9,http://desktop.arcgis.com/en/arcmap/10.3/tools/spatial-analyst-toolbox/deriving-runoff-characteristics.htm,Deriving runoff characteristics—Help | ArcGIS for Desktop,6016,3,1,2,0
tools/spatial-analyst-toolbox/exploring-digital-elevation-models,9,http://desktop.arcgis.com/en/arcmap/10.3/tools/spatial-analyst-toolbox/exploring-digital-elevation-models.htm,Exploring digital elevation models—Help | ArcGIS for Desktop,6071,2,0,2,0
tools/spatial-analyst-toolbox/understanding-drainage-systems,9,http://desktop.arcgis.com/en/arcmap/10.3/tools/spatial-analyst-toolbox/understanding-drainage-systems.htm,Understanding drainage systems—Help | ArcGIS for Desktop,5185,6,2,4,23.5
tools/spatial-analyst-toolbox/slice,10,http://desktop.arcgis.com/en/arcmap/10.3/tools/spatial-analyst-toolbox/slice.htm,Slice—Help | ArcGIS for Desktop,8244,5,2,3,5.222222222
tools/spatial-analyst-toolbox/rescale-by-function,10,http://desktop.arcgis.com/en/arcmap/10.3/tools/spatial-analyst-toolbox/rescale-by-function.htm,Rescale by Function—Help | ArcGIS for Desktop,19563,6,1,5,211.8611111
tools/spatial-analyst-toolbox/reclassify,10,http://desktop.arcgis.com/en/arcmap/10.3/tools/spatial-analyst-toolbox/reclassify.htm,Reclassify—Help | ArcGIS for Desktop,10437,11,7,4,2212.027778
tools/spatial-analyst-toolbox/reclass-by-table,10,http://desktop.arcgis.com/en/arcmap/10.3/tools/spatial-analyst-toolbox/reclass-by-table.htm,Reclass by Table—Help | ArcGIS for Desktop,8321,3,1,2,2.444444444
tools/spatial-analyst-toolbox/reclass-by-ascii-file,10,http://desktop.arcgis.com/en/arcmap/10.3/tools/spatial-analyst-toolbox/reclass-by-ascii-file.htm,Reclass by ASCII File—Help | ArcGIS for Desktop,6998,3,1,2,2.444444444
tools/spatial-analyst-toolbox/lookup,10,http://desktop.arcgis.com/en/arcmap/10.3/tools/spatial-analyst-toolbox/lookup.htm,Lookup—Help | ArcGIS for Desktop,7506,2,0,2,0
tools/spatial-analyst-toolbox/how-rescale-by-function-works,10,http://desktop.arcgis.com/en/arcmap/10.3/tools/spatial-analyst-toolbox/how-rescale-by-function-works.htm,How Rescale by Function works—Help | ArcGIS for Desktop,17782,5,3,2,418.1388889
tools/spatial-analyst-toolbox/grouping-values-into-intervals-or-by-area-with-slice,10,http://desktop.arcgis.com/en/arcmap/10.3/tools/spatial-analyst-toolbox/grouping-values-into-intervals-or-by-area-with-slice.htm,Grouping values into intervals or by area with Slice—Help | ArcGIS for Desktop,7304,6,2,4,210.2222222
tools/spatial-analyst-toolbox/using-reclassification-tables,10,http://desktop.arcgis.com/en/arcmap/10.3/tools/spatial-analyst-toolbox/using-reclassification-tables.htm,Using reclassification tables—Help | ArcGIS for Desktop,11938,8,3,5,419.5833333
tools/spatial-analyst-toolbox/reclass-by-ranges-of-values,10,http://desktop.arcgis.com/en/arcmap/10.3/tools/spatial-analyst-toolbox/reclass-by-ranges-of-values.htm,Reclass by ranges of values—Help | ArcGIS for Desktop,6430,6,4,2,203.1111111
tools/spatial-analyst-toolbox/reclass-by-individual-values,10,http://desktop.arcgis.com/en/arcmap/10.3/tools/spatial-analyst-toolbox/reclass-by-individual-values.htm,Reclass by individual values—Help | ArcGIS for Desktop,4958,6,4,2,203.1111111
tools/spatial-analyst-toolbox/understanding-reclassification,10,http://desktop.arcgis.com/en/arcmap/10.3/tools/spatial-analyst-toolbox/understanding-reclassification.htm,Understanding reclassification—Help | ArcGIS for Desktop,8845,11,6,5,1262.5
tools/spatial-analyst-toolbox/plus,10,http://desktop.arcgis.com/en/arcmap/10.3/tools/spatial-analyst-toolbox/plus.htm,Plus—Help | ArcGIS for Desktop,6550,2,1,1,0
tools/spatial-analyst-toolbox/point-density,11,http://desktop.arcgis.com/en/arcmap/10.3/tools/spatial-analyst-toolbox/point-density.htm,Point Density—Help | ArcGIS for Desktop,11156,2,1,1,8.666666667
tools/spatial-analyst-toolbox/line-density,11,http://desktop.arcgis.com/en/arcmap/10.3/tools/spatial-analyst-toolbox/line-density.htm,Line Density—Help | ArcGIS for Desktop,10379,2,1,1,8.666666667
tools/spatial-analyst-toolbox/kernel-density,11,http://desktop.arcgis.com/en/arcmap/10.3/tools/spatial-analyst-toolbox/kernel-density.htm,Kernel Density—Help | ArcGIS for Desktop,13074,2,1,1,8.666666667
tools/spatial-analyst-toolbox/differences-between-point-line-and-kernel-density,11,http://desktop.arcgis.com/en/arcmap/10.3/tools/spatial-analyst-toolbox/differences-between-point-line-and-kernel-density.htm,"Differences between point, line, and kernel density—Help | ArcGIS for Desktop",5172,5,1,4,16
tools/spatial-analyst-toolbox/understanding-density-analysis,11,http://desktop.arcgis.com/en/arcmap/10.3/tools/spatial-analyst-toolbox/understanding-density-analysis.htm,Understanding density analysis—Help | ArcGIS for Desktop,6101,2,1,1,0
tools/spatial-analyst-toolbox/combinatorial-or,12,http://desktop.arcgis.com/en/arcmap/10.3/tools/spatial-analyst-toolbox/combinatorial-or.htm,Combinatorial Or—Help | ArcGIS for Desktop,7039,2,1,1,0
tools/spatial-analyst-toolbox/combine,12,http://desktop.arcgis.com/en/arcmap/10.3/tools/spatial-analyst-toolbox/combine.htm,Combine—Help | ArcGIS for Desktop,7088,5,2,3,14
tools/spatial-analyst-toolbox/combining-multiple-rasters,12,http://desktop.arcgis.com/en/arcmap/10.3/tools/spatial-analyst-toolbox/combining-multiple-rasters.htm,Combining multiple rasters—Help | ArcGIS for Desktop,5120,3,1,2,0
tools/data-management-toolbox/make-feature-layer,13,http://desktop.arcgis.com/en/arcmap/10.3/tools/data-management-toolbox/make-feature-layer.htm,Make Feature Layer—Help | ArcGIS for Desktop,10287,18,13,5,226.9047619
tools/analysis-toolbox/identity,13,http://desktop.arcgis.com/en/arcmap/10.3/tools/analysis-toolbox/identity.htm,Identity—Help | ArcGIS for Desktop,9641,3,1,2,1.125
tools/data-management-toolbox/dice,13,http://desktop.arcgis.com/en/arcmap/10.3/tools/data-management-toolbox/dice.htm,Dice—Help | ArcGIS for Desktop,7515,1,0,1,0
tools/analysis-toolbox/priority-ranks-and-geoprocessing-tools,13,http://desktop.arcgis.com/en/arcmap/10.3/tools/analysis-toolbox/priority-ranks-and-geoprocessing-tools.htm,Priority ranks and geoprocessing tools—Help | ArcGIS for Desktop,5072,9,1,8,13
tools/analysis-toolbox/update,13,http://desktop.arcgis.com/en/arcmap/10.3/tools/analysis-toolbox/update.htm,Update—Help | ArcGIS for Desktop,8515,2,1,1,1.125
tools/analysis-toolbox/union,13,http://desktop.arcgis.com/en/arcmap/10.3/tools/analysis-toolbox/union.htm,Union—Help | ArcGIS for Desktop,9861,3,2,1,20.125
tools/analysis-toolbox/symmetrical-difference,13,http://desktop.arcgis.com/en/arcmap/10.3/tools/analysis-toolbox/symmetrical-difference.htm,Symmetrical Difference—Help | ArcGIS for Desktop,7736,2,1,1,1.125
tools/analysis-toolbox/erase,13,http://desktop.arcgis.com/en/arcmap/10.3/tools/analysis-toolbox/erase.htm,Erase—Help | ArcGIS for Desktop,8260,2,1,1,1.125
tools/analysis-toolbox/intersect,13,http://desktop.arcgis.com/en/arcmap/10.3/tools/analysis-toolbox/intersect.htm,Intersect—Help | ArcGIS for Desktop,10557,4,2,2,8.125
tools/analysis-toolbox/split,13,http://desktop.arcgis.com/en/arcmap/10.3/tools/analysis-toolbox/split.htm,Split—Help | ArcGIS for Desktop,8601,2,1,1,1.125
tools/analysis-toolbox/clip,13,http://desktop.arcgis.com/en/arcmap/10.3/tools/analysis-toolbox/clip.htm,Clip—Help | ArcGIS for Desktop,8102,2,1,1,1.125
tools/spatial-analyst-toolbox/weighted-sum,14,http://desktop.arcgis.com/en/arcmap/10.3/tools/spatial-analyst-toolbox/weighted-sum.htm,Weighted Sum—Help | ArcGIS for Desktop,7476,5,1,4,0
tools/spatial-analyst-toolbox/weighted-overlay,14,http://desktop.arcgis.com/en/arcmap/10.3/tools/spatial-analyst-toolbox/weighted-overlay.htm,Weighted Overlay—Help | ArcGIS for Desktop,8651,5,1,4,0
tools/spatial-analyst-toolbox/fuzzy-overlay,14,http://desktop.arcgis.com/en/arcmap/10.3/tools/spatial-analyst-toolbox/fuzzy-overlay.htm,Fuzzy Overlay—Help | ArcGIS for Desktop,7848,5,1,4,0
tools/spatial-analyst-toolbox/fuzzy-membership,14,http://desktop.arcgis.com/en/arcmap/10.3/tools/spatial-analyst-toolbox/fuzzy-membership.htm,Fuzzy Membership—Help | ArcGIS for Desktop,9998,7,1,6,7
tools/spatial-analyst-toolbox/overlay-analysis-approaches,14,http://desktop.arcgis.com/en/arcmap/10.3/tools/spatial-analyst-toolbox/overlay-analysis-approaches.htm,Overlay analysis approaches—Help | ArcGIS for Desktop,7850,7,5,2,0
tools/spatial-analyst-toolbox/understanding-overlay-analysis,14,http://desktop.arcgis.com/en/arcmap/10.3/tools/spatial-analyst-toolbox/understanding-overlay-analysis.htm,Understanding overlay analysis—Help | ArcGIS for Desktop,12434,7,6,1,0
tools/spatial-analyst-toolbox/divide,14,http://desktop.arcgis.com/en/arcmap/10.3/tools/spatial-analyst-toolbox/divide.htm,Divide—Help | ArcGIS for Desktop,6965,2,1,1,0
tools/analysis-toolbox/multiple-ring-buffer,15,http://desktop.arcgis.com/en/arcmap/10.3/tools/analysis-toolbox/multiple-ring-buffer.htm,Multiple Ring Buffer—Help | ArcGIS for Desktop,8250,1,0,1,0
tools/analysis-toolbox/buffer,15,http://desktop.arcgis.com/en/arcmap/10.3/tools/analysis-toolbox/buffer.htm,Buffer—Help | ArcGIS for Desktop,16094,8,3,5,191.25
tools/editing-toolbox/densify,15,http://desktop.arcgis.com/en/arcmap/10.3/tools/editing-toolbox/densify.htm,Densify—Help | ArcGIS for Desktop,8036,1,1,0,0
tools/analysis-toolbox/how-buffer-analysis-works,15,http://desktop.arcgis.com/en/arcmap/10.3/tools/analysis-toolbox/how-buffer-analysis-works.htm,How Buffer (Analysis) works—Help | ArcGIS for Desktop,13123,4,3,1,0
tools/data-management-toolbox/add-field,16,http://desktop.arcgis.com/en/arcmap/10.3/tools/data-management-toolbox/add-field.htm,Add Field—Help | ArcGIS for Desktop,11630,6,6,0,0
tools/data-management-toolbox/create-random-points,16,http://desktop.arcgis.com/en/arcmap/10.3/tools/data-management-toolbox/create-random-points.htm,Create Random Points—Help | ArcGIS for Desktop,13904,2,0,2,0
tools/data-management-toolbox/calculate-field,16,http://desktop.arcgis.com/en/arcmap/10.3/tools/data-management-toolbox/calculate-field.htm,Calculate Field—Help | ArcGIS for Desktop,13543,7,6,1,110
tools/spatial-analyst-toolbox/zonal-statistics-as-table,16,http://desktop.arcgis.com/en/arcmap/10.3/tools/spatial-analyst-toolbox/zonal-statistics-as-table.htm,Zonal Statistics as Table—Help | ArcGIS for Desktop,14667,4,0,4,0
tools/spatial-analyst-toolbox/zonal-statistics,16,http://desktop.arcgis.com/en/arcmap/10.3/tools/spatial-analyst-toolbox/zonal-statistics.htm,Zonal Statistics—Help | ArcGIS for Desktop,13377,5,1,4,70.01754386
tools/spatial-analyst-toolbox/zonal-geometry-as-table,16,http://desktop.arcgis.com/en/arcmap/10.3/tools/spatial-analyst-toolbox/zonal-geometry-as-table.htm,Zonal Geometry as Table—Help | ArcGIS for Desktop,9662,3,0,3,0
tools/spatial-analyst-toolbox/zonal-geometry,16,http://desktop.arcgis.com/en/arcmap/10.3/tools/spatial-analyst-toolbox/zonal-geometry.htm,Zonal Geometry—Help | ArcGIS for Desktop,8303,3,0,3,0
tools/spatial-analyst-toolbox/tabulate-area,16,http://desktop.arcgis.com/en/arcmap/10.3/tools/spatial-analyst-toolbox/tabulate-area.htm,Tabulate Area—Help | ArcGIS for Desktop,10355,3,0,3,0
tools/3d-analyst-toolbox/surface-length,17,http://desktop.arcgis.com/en/arcmap/10.3/tools/3d-analyst-toolbox/surface-length.htm,Surface Length—Help | ArcGIS for Desktop,6098,1,0,1,0
tools/3d-analyst-toolbox/surface-spot,17,http://desktop.arcgis.com/en/arcmap/10.3/tools/3d-analyst-toolbox/surface-spot.htm,Surface Spot—Help | ArcGIS for Desktop,5738,1,0,1,0
tools/3d-analyst-toolbox/add-surface-information,17,http://desktop.arcgis.com/en/arcmap/10.3/tools/3d-analyst-toolbox/add-surface-information.htm,Add Surface Information—Help | ArcGIS for Desktop,13278,2,2,0,0
tools/spatial-analyst-toolbox/principal-components,18,http://desktop.arcgis.com/en/arcmap/10.3/tools/spatial-analyst-toolbox/principal-components.htm,Principal Components—Help | ArcGIS for Desktop,9077,4,2,2,13
tools/spatial-analyst-toolbox/how-principal-components-works,18,http://desktop.arcgis.com/en/arcmap/10.3/tools/spatial-analyst-toolbox/how-principal-components-works.htm,How Principal Components works—Help | ArcGIS for Desktop,8626,3,1,2,0
tools/spatial-analyst-toolbox/particle-track,19,http://desktop.arcgis.com/en/arcmap/10.3/tools/spatial-analyst-toolbox/particle-track.htm,Particle Track—Help | ArcGIS for Desktop,9931,4,1,3,13
tools/spatial-analyst-toolbox/how-particle-track-works,19,http://desktop.arcgis.com/en/arcmap/10.3/tools/spatial-analyst-toolbox/how-particle-track-works.htm,How Particle Track works—Help | ArcGIS for Desktop,7461,3,2,1,0
tools/spatial-analyst-toolbox/porous-puff,20,http://desktop.arcgis.com/en/arcmap/10.3/tools/spatial-analyst-toolbox/porous-puff.htm,Porous Puff—Help | ArcGIS for Desktop,10996,5,1,4,13
tools/spatial-analyst-toolbox/how-porous-puff-works,20,http://desktop.arcgis.com/en/arcmap/10.3/tools/spatial-analyst-toolbox/how-porous-puff-works.htm,How Porous Puff works—Help | ArcGIS for Desktop,13266,4,3,1,0
tools/spatial-analyst-toolbox/cell-statistics,21,http://desktop.arcgis.com/en/arcmap/10.3/tools/spatial-analyst-toolbox/cell-statistics.htm,Cell Statistics—Help | ArcGIS for Desktop,8010,3,1,2,13
tools/spatial-analyst-toolbox/how-cell-statistics-works,21,http://desktop.arcgis.com/en/arcmap/10.3/tools/spatial-analyst-toolbox/how-cell-statistics-works.htm,How Cell Statistics works—Help | ArcGIS for Desktop,8175,2,1,1,0
tools/data-management-toolbox/calculate-value,22,http://desktop.arcgis.com/en/arcmap/10.3/tools/data-management-toolbox/calculate-value.htm,Calculate Value—Help | ArcGIS for Desktop,10464,2,0,2,0
tools/spatial-analyst-toolbox/less-than,22,http://desktop.arcgis.com/en/arcmap/10.3/tools/spatial-analyst-toolbox/less-than.htm,Less Than—Help | ArcGIS for Desktop,6855,2,1,1,6.5
tools/spatial-analyst-toolbox/greater-than,22,http://desktop.arcgis.com/en/arcmap/10.3/tools/spatial-analyst-toolbox/greater-than.htm,Greater Than—Help | ArcGIS for Desktop,6925,2,1,1,6.5
tools/spatial-analyst-toolbox/dendrogram,23,http://desktop.arcgis.com/en/arcmap/10.3/tools/spatial-analyst-toolbox/dendrogram.htm,Dendrogram—Help | ArcGIS for Desktop,7732,2,2,0,0
tools/spatial-analyst-toolbox/evaluating-classes-and-clusters-with-dendrograms,23,http://desktop.arcgis.com/en/arcmap/10.3/tools/spatial-analyst-toolbox/evaluating-classes-and-clusters-with-dendrograms.htm,Evaluating classes and clusters with dendrograms—Help | ArcGIS for Desktop,4749,3,1,2,1
tools/spatial-analyst-toolbox/rank,24,http://desktop.arcgis.com/en/arcmap/10.3/tools/spatial-analyst-toolbox/rank.htm,Rank—Help | ArcGIS for Desktop,7207,5,3,2,6.5
tools/spatial-analyst-toolbox/popularity,24,http://desktop.arcgis.com/en/arcmap/10.3/tools/spatial-analyst-toolbox/popularity.htm,Popularity—Help | ArcGIS for Desktop,8269,5,2,3,6.5
tools/spatial-analyst-toolbox/the-value-from-an-input-list-meeting-a-specified-criteria,24,http://desktop.arcgis.com/en/arcmap/10.3/tools/spatial-analyst-toolbox/the-value-from-an-input-list-meeting-a-specified-criteria.htm,Finding the value from an input list meeting a specified criteria—Help | ArcGIS for Desktop,6343,6,2,4,1
tools/analysis-toolbox/point-distance,25,http://desktop.arcgis.com/en/arcmap/10.3/tools/analysis-toolbox/point-distance.htm,Point Distance—Help | ArcGIS for Desktop,7610,4,2,2,0
tools/analysis-toolbox/generate-near-table,25,http://desktop.arcgis.com/en/arcmap/10.3/tools/analysis-toolbox/generate-near-table.htm,Generate Near Table—Help | ArcGIS for Desktop,12674,7,4,3,27.64285714
tools/analysis-toolbox/near,25,http://desktop.arcgis.com/en/arcmap/10.3/tools/analysis-toolbox/near.htm,Near—Help | ArcGIS for Desktop,13458,6,3,3,15.5
tools/data-management-toolbox/xy-to-line,25,http://desktop.arcgis.com/en/arcmap/10.3/tools/data-management-toolbox/xy-to-line.htm,XY To Line—Help | ArcGIS for Desktop,9462,2,2,0,0
tools/analysis-toolbox/how-near-analysis-works,25,http://desktop.arcgis.com/en/arcmap/10.3/tools/analysis-toolbox/how-near-analysis-works.htm,How proximity tools calculate distance—Help | ArcGIS for Desktop,10773,11,3,8,43
tools/spatial-analyst-toolbox/darcy-velocity,26,http://desktop.arcgis.com/en/arcmap/10.3/tools/spatial-analyst-toolbox/darcy-velocity.htm,Darcy Velocity—Help | ArcGIS for Desktop,10719,4,2,2,6.5
tools/spatial-analyst-toolbox/darcy-flow,26,http://desktop.arcgis.com/en/arcmap/10.3/tools/spatial-analyst-toolbox/darcy-flow.htm,Darcy Flow—Help | ArcGIS for Desktop,11085,4,2,2,6.5
tools/spatial-analyst-toolbox/what-is-darcy-flow-analysis,26,http://desktop.arcgis.com/en/arcmap/10.3/tools/spatial-analyst-toolbox/what-is-darcy-flow-analysis.htm,What is Darcy flow analysis?—Help | ArcGIS for Desktop,7666,6,2,4,2
tools/spatial-analyst-toolbox/lowest-position,27,http://desktop.arcgis.com/en/arcmap/10.3/tools/spatial-analyst-toolbox/lowest-position.htm,Lowest Position—Help | ArcGIS for Desktop,6849,6,3,3,6.5
tools/spatial-analyst-toolbox/highest-position,27,http://desktop.arcgis.com/en/arcmap/10.3/tools/spatial-analyst-toolbox/highest-position.htm,Highest Position—Help | ArcGIS for Desktop,6850,6,3,3,6.5
tools/spatial-analyst-toolbox/the-position-from-an-input-list-meeting-a-specified-criteria,27,http://desktop.arcgis.com/en/arcmap/10.3/tools/spatial-analyst-toolbox/the-position-from-an-input-list-meeting-a-specified-criteria.htm,Finding the position from an input list meeting a specified criterion—Help | ArcGIS for Desktop,5207,6,2,4,0
tools/spatial-analyst-toolbox/majority-filter,28,http://desktop.arcgis.com/en/arcmap/10.3/tools/spatial-analyst-toolbox/majority-filter.htm,Majority Filter—Help | ArcGIS for Desktop,8601,5,3,2,6.5
tools/spatial-analyst-toolbox/boundary-clean,28,http://desktop.arcgis.com/en/arcmap/10.3/tools/spatial-analyst-toolbox/boundary-clean.htm,Boundary Clean—Help | ArcGIS for Desktop,8108,5,3,2,6.5
tools/spatial-analyst-toolbox/smoothing-zone-edges-with-boundary-clean-and-majority-filter,28,http://desktop.arcgis.com/en/arcmap/10.3/tools/spatial-analyst-toolbox/smoothing-zone-edges-with-boundary-clean-and-majority-filter.htm,Smoothing zone edges with Boundary Clean and Majority Filter—Help | ArcGIS for Desktop,7395,4,0,4,0
tools/spatial-analyst-toolbox/shrink,29,http://desktop.arcgis.com/en/arcmap/10.3/tools/spatial-analyst-toolbox/shrink.htm,Shrink—Help | ArcGIS for Desktop,6791,7,4,3,4.333333333
tools/spatial-analyst-toolbox/nibble,29,http://desktop.arcgis.com/en/arcmap/10.3/tools/spatial-analyst-toolbox/nibble.htm,Nibble—Help | ArcGIS for Desktop,6946,7,4,3,4.333333333
tools/spatial-analyst-toolbox/expand,29,http://desktop.arcgis.com/en/arcmap/10.3/tools/spatial-analyst-toolbox/expand.htm,Expand—Help | ArcGIS for Desktop,6743,7,4,3,4.333333333
tools/spatial-analyst-toolbox/generalizing-zones-with-nibble-shrink-and-expand,29,http://desktop.arcgis.com/en/arcmap/10.3/tools/spatial-analyst-toolbox/generalizing-zones-with-nibble-shrink-and-expand.htm,"Generalizing zones with Nibble, Shrink, and Expand—Help | ArcGIS for Desktop",7590,6,0,6,0
tools/spatial-analyst-toolbox/trend,30,http://desktop.arcgis.com/en/arcmap/10.3/tools/spatial-analyst-toolbox/trend.htm,Trend—Help | ArcGIS for Desktop,8869,4,1,3,3.25
tools/spatial-analyst-toolbox/topo-to-raster-by-file,30,http://desktop.arcgis.com/en/arcmap/10.3/tools/spatial-analyst-toolbox/topo-to-raster-by-file.htm,Topo to Raster by File—Help | ArcGIS for Desktop,14389,4,1,3,3.25
tools/spatial-analyst-toolbox/topo-to-raster,30,http://desktop.arcgis.com/en/arcmap/10.3/tools/spatial-analyst-toolbox/topo-to-raster.htm,Topo to Raster—Help | ArcGIS for Desktop,22247,4,1,3,3.25
tools/spatial-analyst-toolbox/spline-with-barriers,30,http://desktop.arcgis.com/en/arcmap/10.3/tools/spatial-analyst-toolbox/spline-with-barriers.htm,Spline with Barriers—Help | ArcGIS for Desktop,9690,4,1,3,3.25
tools/spatial-analyst-toolbox/spline,30,http://desktop.arcgis.com/en/arcmap/10.3/tools/spatial-analyst-toolbox/spline.htm,Spline—Help | ArcGIS for Desktop,8991,4,1,3,3.25
tools/spatial-analyst-toolbox/natural-neighbor,30,http://desktop.arcgis.com/en/arcmap/10.3/tools/spatial-analyst-toolbox/natural-neighbor.htm,Natural Neighbor—Help | ArcGIS for Desktop,8687,4,1,3,3.25
tools/spatial-analyst-toolbox/kriging,30,http://desktop.arcgis.com/en/arcmap/10.3/tools/spatial-analyst-toolbox/kriging.htm,Kriging—Help | ArcGIS for Desktop,12161,4,1,3,3.25
tools/spatial-analyst-toolbox/idw,30,http://desktop.arcgis.com/en/arcmap/10.3/tools/spatial-analyst-toolbox/idw.htm,IDW—Help | ArcGIS for Desktop,12197,4,1,3,3.25
tools/spatial-analyst-toolbox/comparing-interpolation-methods,30,http://desktop.arcgis.com/en/arcmap/10.3/tools/spatial-analyst-toolbox/comparing-interpolation-methods.htm,Comparing interpolation methods—Help | ArcGIS for Desktop,6232,18,9,9,77
tools/spatial-analyst-toolbox/understanding-interpolation-analysis,30,http://desktop.arcgis.com/en/arcmap/10.3/tools/spatial-analyst-toolbox/understanding-interpolation-analysis.htm,Understanding interpolation analysis—Help | ArcGIS for Desktop,6513,10,9,1,0
tools/spatial-analyst-toolbox/less-than-frequency,31,http://desktop.arcgis.com/en/arcmap/10.3/tools/spatial-analyst-toolbox/less-than-frequency.htm,Less Than Frequency—Help | ArcGIS for Desktop,6757,8,4,4,3.714285714
tools/spatial-analyst-toolbox/greater-than-frequency,31,http://desktop.arcgis.com/en/arcmap/10.3/tools/spatial-analyst-toolbox/greater-than-frequency.htm,Greater Than Frequency—Help | ArcGIS for Desktop,6823,8,4,4,3.714285714
tools/spatial-analyst-toolbox/equal-to-frequency,31,http://desktop.arcgis.com/en/arcmap/10.3/tools/spatial-analyst-toolbox/equal-to-frequency.htm,Equal To Frequency—Help | ArcGIS for Desktop,6779,8,4,4,3.714285714
tools/spatial-analyst-toolbox/the-number-of-occurrences-from-an-input-list-meeting-a-specified-criteria,31,http://desktop.arcgis.com/en/arcmap/10.3/tools/spatial-analyst-toolbox/the-number-of-occurrences-from-an-input-list-meeting-a-specified-criteria.htm,Finding the  number of occurrences from an input list meeting a specified criterion—Help | ArcGIS for Desktop,5024,10,3,7,6
tools/geocoding-toolbox/rebuild-address-locator,32,http://desktop.arcgis.com/en/arcmap/10.3/tools/geocoding-toolbox/rebuild-address-locator.htm,Rebuild Address Locator—Help | ArcGIS for Desktop,6226,3,0,3,0
tools/geocoding-toolbox/create-composite-address-locator,32,http://desktop.arcgis.com/en/arcmap/10.3/tools/geocoding-toolbox/create-composite-address-locator.htm,Create Composite Address Locator—Help | ArcGIS for Desktop,7770,5,3,2,0
tools/geocoding-toolbox/create-address-locator,32,http://desktop.arcgis.com/en/arcmap/10.3/tools/geocoding-toolbox/create-address-locator.htm,Create Address Locator—Help | ArcGIS for Desktop,10862,6,4,2,0
tools/spatial-analyst-toolbox/raster-calculator,33,http://desktop.arcgis.com/en/arcmap/10.3/tools/spatial-analyst-toolbox/raster-calculator.htm,Raster Calculator—Help | ArcGIS for Desktop,11239,6,5,1,0
tools/spatial-analyst-toolbox/how-raster-calculator-works,33,http://desktop.arcgis.com/en/arcmap/10.3/tools/spatial-analyst-toolbox/how-raster-calculator-works.htm,How Raster Calculator works—Help | ArcGIS for Desktop,7813,5,2,3,1
tools/spatial-analyst-toolbox/building-expressions-in-raster-calculator,33,http://desktop.arcgis.com/en/arcmap/10.3/tools/spatial-analyst-toolbox/building-expressions-in-raster-calculator.htm,Building expressions in Raster Calculator—Help | ArcGIS for Desktop,7751,5,1,4,0
tools/spatial-analyst-toolbox/exp2,34,http://desktop.arcgis.com/en/arcmap/10.3/tools/spatial-analyst-toolbox/exp2.htm,Exp2—Help | ArcGIS for Desktop,6367,5,2,3,0
tools/spatial-analyst-toolbox/exp10,34,http://desktop.arcgis.com/en/arcmap/10.3/tools/spatial-analyst-toolbox/exp10.htm,Exp10—Help | ArcGIS for Desktop,6384,5,2,3,0
tools/spatial-analyst-toolbox/exp,34,http://desktop.arcgis.com/en/arcmap/10.3/tools/spatial-analyst-toolbox/exp.htm,Exp—Help | ArcGIS for Desktop,6429,5,2,3,0
tools/spatial-analyst-toolbox/log2,35,http://desktop.arcgis.com/en/arcmap/10.3/tools/spatial-analyst-toolbox/log2.htm,Log2—Help | ArcGIS for Desktop,6104,5,2,3,0
tools/spatial-analyst-toolbox/log10,35,http://desktop.arcgis.com/en/arcmap/10.3/tools/spatial-analyst-toolbox/log10.htm,Log10—Help | ArcGIS for Desktop,6131,5,2,3,0
tools/spatial-analyst-toolbox/ln,35,http://desktop.arcgis.com/en/arcmap/10.3/tools/spatial-analyst-toolbox/ln.htm,Ln—Help | ArcGIS for Desktop,6174,5,2,3,0
tools/spatial-analyst-toolbox/square-root,36,http://desktop.arcgis.com/en/arcmap/10.3/tools/spatial-analyst-toolbox/square-root.htm,Square Root—Help | ArcGIS for Desktop,6004,5,2,3,0
tools/spatial-analyst-toolbox/square,36,http://desktop.arcgis.com/en/arcmap/10.3/tools/spatial-analyst-toolbox/square.htm,Square—Help | ArcGIS for Desktop,5875,5,2,3,0
tools/spatial-analyst-toolbox/power,36,http://desktop.arcgis.com/en/arcmap/10.3/tools/spatial-analyst-toolbox/power.htm,Power—Help | ArcGIS for Desktop,6764,5,2,3,0
tools/server-toolbox/stage-service,37,http://desktop.arcgis.com/en/arcmap/10.3/tools/server-toolbox/stage-service.htm,Stage Service—Help | ArcGIS for Desktop,8031,4,2,2,0
tools/server-toolbox/upload-service-definition,37,http://desktop.arcgis.com/en/arcmap/10.3/tools/server-toolbox/upload-service-definition.htm,Upload Service Definition—Help | ArcGIS for Desktop,13638,4,2,2,0
tools/geocoding-toolbox/geocode-addresses,38,http://desktop.arcgis.com/en/arcmap/10.3/tools/geocoding-toolbox/geocode-addresses.htm,Geocode Addresses—Help | ArcGIS for Desktop,9241,3,2,1,0
tools/geocoding-toolbox/rematch-addresses,38,http://desktop.arcgis.com/en/arcmap/10.3/tools/geocoding-toolbox/rematch-addresses.htm,Rematch Addresses—Help | ArcGIS for Desktop,5336,3,1,2,0
